..........
.####.....
.....###..
..##......
.....#....
......####