WIDTH  10
HEIGHT 6
START  0 0
GOAL   5 5
..........
#####.####
......##..
..##......
.....#....
......####
